1111111111111111
1..............1
1..............1
1..............1
1..............1
1..............1
1..............D
1......AA......D
1......AA......D
1..............D
1..............1
1..............1
1..............1
1..............1
1..............1
111111DDDD111111