111111DDDD111111
1..............1
1..............1
1..............1
1..............1
1..............1
1..............1
1......AA......1
1......AA......1
1..............1
1..............1
1..............1
1..............1
1..............1
1..............1
111111DDDD111111