1111111111111111
1..............1
1..............1
1..............1
1..............1
1..............1
D..............1
D......AA..W...1
D......AA......1
D..............1
1..............1
1..............1
1..............1
1..............1
1..............1
1111111111111111