1111111111111111
1..............1
1..............1
1..............1
1..............1
1..............1
D..............D
D......AA......D
D......AA......D
D..............D
1..............1
1..............1
1..............1
1..............1
1..............1
1111111111111111