1111111111111111
1..............1
1..............1
1..............1
1..............1
1..............1
1..............D
1...W..AA......D
1......AA......D
1..............D
1..............1
1..............1
1..............1
1..............1
1..............1
1111111111111111