111111DDDD111111
1..............1
1..............1
1..............1
1..............1
1..............1
1..............1
1......AA......1
1......AA......1
1..............1
1..............1
1..............1
1......W.......1
1..............1
1..............1
1111111111111111